1
1 1 1 1 1 1 1 1 1 1 1 1 1 1 1 3 3 3 3 3 3
1 1 1 1 1 1 1 1 1 1 1 1 1 1 1 1 3 3 3 3 3
1 1 1 1 1 1 1 1 1 1 1 1 1 1 1 1 1 1 3 3 3
1 1 1 1 1 1 1 1 1 1 1 1 1 1 1 1 1 1 1 1 1
1 1 1 1 1 1 1 1 1 1 1 1 1 1 1 1 1 1 1 1 1
1 1 1 1 1 1 1 1 1 1 1 1 1 1 1 1 1 1 1 1 1
1 1 1 1 1 1 1 1 1 1 1 1 1 1 1 1 1 1 1 1 1
1 1 1 1 1 1 1 1 1 3 3 1 1 1 1 1 1 1 1 1 1
1 1 1 1 1 1 1 1 3 3 1 1 1 1 1 1 1 1 1 1 1
1 1 1 1 1 1 1 3 3 1 1 1 1 1 1 1 1 1 1 1 1
1 1 1 1 1 1 1 1 3 1 1 1 1 1 1 1 1 1 1 1 1
1 1 1 1 1 1 1 1 1 1 1 1 1 1 1 1 1 1 1 1 1
1 1 1 1 1 1 1 4 4 4 4 4 4 4 1 1 1 1 1 1 1
1 1 1 1 1 1 4 4 4 4 4 4 4 4 4 1 1 1 1 1 1
1 1 1 1 1 4 4 4 1 1 1 1 1 4 4 4 1 1 1 1 1
4 4 4 4 4 4 4 1 1 1 3 1 1 1 4 4 4 4 4 4 4
4 4 4 4 4 4 4 1 1 3 3 3 1 1 4 4 4 4 4 4 4
2
1 1 1 1 1 1 1 1 1 0 0 0 0 0 0 0 0 0 0 0 0
1 1 1 1 1 1 1 1 0 0 40 0 0 0 0 9 0 0 2 2 0
1 1 1 1 1 1 1 1 0 0 0 0 0 0 0 0 0 0 2 2 0
1 1 1 1 1 1 1 1 0 0 0 0 0 2 2 2 0 0 2 2 2
1 1 1 1 1 1 1 1 0 0 0 0 0 2 0 0 0 0 0 0 2
1 1 1 1 1 1 1 0 8 0 0 0 30 2 0 0 0 0 0 0 2
1 1 1 1 1 1 1 0 0 0 0 0 0 0 0 0 0 0 0 0 2
1 1 1 1 1 1 1 5 0 0 0 0 0 0 0 0 0 0 0 0 2
1 1 1 1 1 1 0 0 0 0 0 6 0 2 0 0 0 0 0 0 2
1 1 1 1 1 1 0 0 0 0 0 0 0 2 0 0 0 0 0 0 2
1 1 1 0 0 0 0 0 0 0 0 0 0 2 2 2 0 0 2 2 2
1 1 1 0 8 0 0 52 52 0 0 0 52 52 0 0 0 0 0 30 5
10 0 7 0 5 0 52 53 0 20 20 20 0 51 52 0 5 0 0 0 0
0 0 0 0 0 52 53 0 0 20 20 20 0 0 51 52 0 0 0 0 9
52 52 52 0 51 0 0 0 0 0 0 0 0 0 0 0 53 0 52 52 52
0 0 0 20 20 0 0 0 6 0 0 0 0 5 0 0 20 20 0 0 0
0 0 0 20 20 0 0 0 0 0 11 0 0 0 0 0 20 20 0 0 0
3
1 1 1 1 1 1 0 0 0 0 0 0 0 0 0 0 0 0 0 0 0
1 1 1 1 1 1 5 0 0 0 0 0 0 0 0 0 0 0 0 0 0
1 1 1 1 1 1 0 0 0 0 0 0 0 0 0 0 0 0 2 2 0
1 1 1 1 1 0 0 0 0 0 0 0 0 2 0 2 0 0 2 2 2
1 1 1 1 1 0 0 0 0 0 0 0 0 0 0 0 0 0 0 0 2
1 1 1 1 0 0 0 0 0 0 0 0 0 2 0 0 0 0 0 0 2
1 1 1 1 0 0 0 0 0 0 0 0 0 0 0 0 0 0 0 0 2
1 1 0 0 0 0 0 0 0 0 0 0 0 0 0 0 0 0 0 0 2
1 1 7 0 0 0 0 0 0 0 0 0 0 2 0 0 0 0 0 0 2
5 0 0 0 0 0 0 0 0 0 0 0 0 0 0 0 0 0 0 0 2
0 0 0 0 0 0 0 0 0 0 0 0 0 2 0 2 0 0 2 0 2
0 0 0 0 0 0 0 0 0 0 0 0 0 0 0 0 0 0 0 0 0
0 0 0 0 0 0 0 0 0 0 0 0 0 0 0 0 0 0 0 0 0
0 0 0 0 0 0 0 0 0 0 0 0 0 0 0 0 0 0 0 0 0
0 0 0 0 0 0 0 0 0 0 0 0 0 0 0 0 0 0 0 0 0
0 0 0 0 0 0 0 0 0 0 0 0 0 0 0 0 0 0 0 0 0
0 0 0 0 0 0 0 0 0 0 12 0 0 0 0 0 0 0 0 0 0
4
1 1 1 1 0 0 0 0 0 0 0 0 0 0 0 0 0 0 0 0 0
1 1 1 1 0 0 0 0 0 0 0 0 0 0 0 0 0 0 0 0 0
1 1 0 0 0 5 0 0 0 0 0 0 0 0 0 0 0 0 0 0 0
1 1 0 0 0 0 0 0 0 0 0 0 0 2 2 2 2 2 2 2 2
1 0 9 0 0 0 0 0 0 0 0 0 0 2 2 2 2 2 2 2 2
1 0 5 0 0 0 0 0 0 0 0 0 0 2 2 2 2 2 2 2 2
0 0 0 0 0 0 0 0 0 0 0 0 0 2 2 2 2 2 2 2 2
0 0 0 0 0 0 0 0 0 0 0 0 0 2 2 2 2 2 2 2 2
0 0 0 0 0 0 0 0 0 0 0 0 0 2 2 2 2 2 2 2 2
0 0 0 0 0 0 0 0 0 0 0 0 0 2 2 2 2 2 2 2 2
0 0 0 0 0 0 0 0 0 0 0 0 0 2 2 2 2 2 2 2 2
0 0 0 0 0 0 0 0 0 0 0 0 0 0 0 0 0 0 0 0 0
0 0 0 0 0 0 0 0 0 0 0 0 0 0 0 0 0 0 0 0 0
0 0 0 0 0 0 0 0 0 0 0 0 0 0 0 0 0 0 0 0 0
0 0 0 0 0 0 0 0 0 0 0 0 0 0 0 0 0 0 0 0 0
0 0 0 0 0 0 0 0 0 0 0 0 0 0 0 0 0 0 0 0 0
0 0 0 0 0 0 0 0 0 0 0 0 0 0 0 0 0 0 0 0 0
5
0 0 9 0 0 0 0 0 0 0 0 0 0 0 0 0 0 0 0 0 0
0 0 0 0 0 0 0 0 0 0 0 0 0 0 0 0 0 0 0 0 0
0 0 0 0 0 0 0 0 0 0 0 0 0 0 0 0 0 0 0 0 0
5 0 0 0 0 0 0 0 0 0 0 0 0 0 0 0 0 0 0 0 0
0 0 0 0 0 0 0 0 0 0 0 0 0 0 0 0 0 0 0 0 0
0 0 0 0 0 0 0 0 0 0 0 0 0 0 0 0 0 0 0 0 0
0 0 0 0 0 0 0 0 0 0 0 0 0 0 0 0 0 0 0 0 0
0 0 0 0 0 0 0 0 0 0 0 0 0 0 0 0 0 0 0 0 0
0 0 0 0 0 0 0 0 0 0 0 0 0 0 0 0 0 0 0 0 0
0 0 0 0 0 0 0 0 0 0 0 0 0 0 0 0 0 0 0 0 0
0 0 0 0 0 0 0 0 0 0 0 0 0 0 0 0 0 0 0 0 0
0 0 0 0 0 0 0 0 0 0 0 0 0 0 0 0 0 0 0 0 0
0 0 0 0 0 0 0 0 0 0 0 0 0 0 0 0 0 0 0 0 0
0 0 0 0 0 0 0 0 0 0 0 0 0 0 0 0 0 0 0 0 0
0 0 0 0 0 0 0 0 0 0 0 0 0 0 0 0 0 0 0 0 0
0 0 0 0 0 0 0 0 0 0 0 0 0 0 0 0 0 0 0 0 0
0 0 0 0 0 0 0 0 0 0 0 0 0 0 0 0 0 0 0 0 0